apple	NNG
is	MAG
red.	AJ
This	AX
movie	NNG
is	MAG
my	VXA
best	VXA
movie.	NNG
Wow	IC
I	NP
like	VV
this	AX
Movie.	NNG
Shrek	NNP
is	MAG
my	VXA
worst	VXA
movie	NNG
ever.	DT